W	W	W
W	F	W
W	P	W
W	P	W
W	P	W
W	N	W
W	W	W
