W	W	W	W	W	W	W	W	W	W	W	W	W	W	W	W	W
W	W	-	-	-	W	W	W	W	W	F	W	W	W	W	W	W
W	-	-	W	-	-	-	W	W	W	-	W	W	W	W	W	W
W	-	W	W	W	W	-	W	W	W	-	W	W	W	W	W	W
W	-	W	W	W	W	-	W	-	-	-	-	W	W	W	W	W
W	-	W	W	W	W	-	W	-	W	W	-	-	W	W	W	W
W	-	W	W	W	W	-	-	-	W	W	W	-	W	W	W	W
W	-	W	W	W	W	W	W	W	W	W	W	-	-	W	W	W
W	-	-	W	W	-	-	-	-	W	W	W	W	-	W	W	W
W	W	-	W	-	-	W	W	-	-	W	W	W	-	W	W	W
W	W	-	W	-	W	W	W	W	-	W	W	W	-	W	W	W
W	W	-	W	-	W	W	W	W	-	W	W	W	-	W	W	W
W	W	-	-	-	W	W	W	-	-	W	W	W	-	W	W	W
W	W	W	W	W	-	-	-	-	W	W	W	W	-	W	W	W
W	W	W	W	-	-	W	W	W	W	W	W	W	-	W	W	W
W	W	W	W	-	W	W	W	-	-	-	-	-	-	W	W	W
W	W	W	W	-	-	-	-	-	W	-	W	W	W	W	W	W
W	W	W	W	W	W	W	W	W	W	-	W	W	W	W	W	W
W	W	W	W	W	W	W	W	W	W	N	W	W	W	W	W	W
W	W	W	W	W	W	W	W	W	W	W	W	W	W	W	W	W